{
    "map": [
        [0,0,0,0,0,0,0,0,0,0,0,0,0,0,0,0],
        [0,0,0,0,0,0,0,0,0,0,0,0,0,0,0,0],
        [0,0,0,0,0,0,0,0,0,0,0,0,0,0,0,0],
        [0,0,0,0,0,0,0,0,0,0,0,0,0,0,0,0],
        [0,0,0,0,0,0,0,0,0,0,0,0,0,0,0,0],
        [2,0,0,0,0,0,0,0,0,0,0,0,0,0,0,0],
        [1,0,0,0,0,0,0,0,0,0,0,0,0,0,0,0],
        [1,0,0,0,0,0,0,0,0,0,0,0,0,0,0,0],
        [1,0,0,0,0,0,0,2,0,0,0,0,0,0,0,0],
        [1,0,0,0,0,0,0,1,0,0,0,0,2,0,0,9],
        [1,2,2,2,2,2,2,1,2,2,2,2,1,2,2,2]
    ],
    "size": {
        "x": 16,
        "y": 11
    },
    "start": {
        "x": 2,
        "y": 9
    }
}