{
    "map": [
        [0,0,0,0,0,0,0,0,0,0,0,0,0,0,0,0,0,0,0,0],
        [0,0,0,0,0,0,0,0,0,0,0,0,0,0,0,0,0,0,0,0],
        [0,0,0,0,0,0,0,0,0,0,0,0,0,0,0,0,0,0,0,0],
        [0,0,0,0,0,0,0,0,0,0,0,0,0,0,0,0,0,0,0,0],
        [0,0,0,0,0,0,0,0,0,0,0,0,0,0,0,0,0,0,0,0],
        [0,0,0,0,0,0,0,0,0,0,0,0,0,0,0,0,0,0,0,0],
        [0,0,0,0,0,0,0,0,0,0,0,0,0,0,0,0,0,0,0,0],
        [0,0,0,0,0,0,0,0,0,0,0,0,0,0,0,0,0,5,0,0],
        [0,0,0,0,0,0,0,0,0,0,0,0,0,5,0,0,5,2,0,0],
        [0,0,0,0,0,0,0,0,0,0,0,0,0,0,0,5,2,1,0,0],
        [0,0,0,0,0,0,0,0,0,0,0,0,0,5,0,2,1,1,0,9],
        [2,2,2,2,2,2,2,2,2,2,2,2,2,2,2,1,1,1,2,2]
    ],
    "size": {
        "x": 15,
        "y": 12
    },
    "start": {
        "x": 1,
        "y": 10
    }
}