{
    "map": [
        [0,0,0,0,0,0,0,0,0,0,0,0,0,0,0,0],
        [0,0,0,0,0,0,0,9,0,0,0,0,0,0,0,0],
        [0,0,0,0,0,0,3,3,3,0,0,0,0,0,0,0],
        [0,0,0,0,0,3,0,0,0,3,0,0,3,0,0,0],
        [0,0,0,0,0,0,0,0,0,3,0,0,0,3,0,0],
        [0,0,0,0,0,0,0,3,3,0,0,0,0,0,3,0],
        [0,0,0,0,0,0,0,0,0,3,0,0,0,0,0,3],
        [0,0,0,0,0,0,0,0,0,3,0,0,0,0,0,0],
        [0,0,0,0,0,3,0,0,0,3,0,0,0,0,0,0],
        [0,0,0,0,0,0,3,3,3,0,0,0,0,0,0,0],
        [0,0,0,0,0,0,0,0,0,0,0,0,0,0,0,0],
        [2,2,2,2,2,2,2,2,2,2,2,2,2,2,2,2]
    ],
    "size": {
        "x": 16,
        "y": 12
    },
    "start": {
        "x": 1,
        "y": 10
    }
}