{
    "map": [
        [1,1,1,0,0,0,0,0,0,0,0,0,0,0,1,1],
        [0,0,0,0,0,0,0,0,0,0,0,5,0,0,0,9],
        [0,0,0,0,0,0,0,2,2,2,2,2,2,2,2,2],
        [0,0,0,0,0,0,2,1,0,0,0,0,0,0,0,0],
        [0,0,0,0,0,2,1,0,0,0,0,0,0,0,0,0],
        [0,0,0,0,2,1,0,0,0,0,0,0,0,0,0,2],
        [0,0,0,2,1,0,0,0,0,0,0,0,0,0,0,1],
        [0,0,2,1,0,0,0,0,0,0,0,0,0,0,0,1],
        [0,2,1,0,0,0,0,0,0,0,0,0,0,0,0,1],
        [2,1,0,0,0,0,0,0,0,0,0,0,0,0,0,1],
        [0,0,0,0,0,0,0,0,0,0,0,0,0,6,0,1],
        [7,7,2,2,2,2,2,2,2,2,2,2,2,2,2,2]
    ],
    "size": {
        "x": 16,
        "y": 12
    },
    "start": {
        "x": 3,
        "y": 10
    }
}