{
    "map": [
        [1,0,0,0,0,0,0,0,0,0,0,0,0,0,0,0,0,0,0,0],
        [1,0,0,0,0,0,0,0,0,0,0,0,0,0,0,0,0,0,0,0],
        [0,9,0,0,0,0,0,0,0,0,0,0,0,0,0,0,0,0,0,0],
        [1,0,0,0,0,0,0,0,0,0,0,0,0,0,0,0,0,0,0,0],
        [1,0,0,0,0,0,0,0,0,0,0,0,0,0,0,0,0,0,0,0],
        [1,0,0,0,0,0,0,0,0,0,0,0,0,0,0,0,0,0,0,0],
        [0,0,0,0,0,0,0,0,0,0,0,0,0,0,0,0,0,0,0,0],
        [0,0,0,0,0,0,0,0,0,0,0,0,0,0,0,0,0,0,0,0],
        [2,2,2,2,2,2,2,2,2,2,2,2,2,2,2,2,2,2,0,0]
    ],
    "size": {
        "x": 20,
        "y": 9
    },
    "start": {
        "x": 10,
        "y": 7
    }
}