{
    "map": [
        [0,1,0,0,0,0,0,0,0,0,0,0,0,0,0,0,0,0,0,0],
        [0,1,0,0,0,0,0,0,0,0,0,0,0,0,0,0,0,0,0,0],
        [0,0,9,0,0,0,0,0,0,0,0,0,0,0,0,0,0,0,0,0],
        [0,1,0,0,0,0,0,0,0,0,0,0,0,0,0,0,0,0,0,0],
        [0,1,0,0,0,0,0,0,0,0,0,0,0,0,0,0,0,0,0,0],
        [0,1,0,0,0,0,0,0,0,0,0,0,0,0,0,0,0,0,0,0],
        [0,0,0,0,0,0,0,0,0,0,0,0,0,0,0,0,0,0,0,0],
        [0,0,0,0,0,0,0,0,0,0,0,0,0,0,0,0,0,0,0,0],
        [0,2,2,2,2,2,2,2,2,2,2,2,2,2,2,2,2,2,2,0]
    ],
    "size": {
        "x": 20,
        "y": 9
    },
    "start": {
        "x": 9,
        "y": 7
    }
}