{
    "map": [
        [0,0,0,0,0,0,0,0,0,0,9,0,0,0,0,0,0,0,0],
        [0,0,0,0,0,0,0,0,0,0,0,0,0,0,0,0,0,0,0],
        [0,0,2,2,2,2,2,2,0,0,0,0,0,0,2,2,2,0,0],
        [0,2,1,0,0,0,0,0,0,0,0,0,0,0,0,0,5,0,0],
        [2,1,0,0,0,0,0,0,0,0,0,0,0,0,0,0,0,0,0],
        [1,0,0,0,0,0,0,0,0,0,0,0,0,0,0,0,0,5,2],
        [0,0,5,0,0,0,0,0,0,0,0,0,0,0,0,5,0,2,1],
        [0,0,0,0,0,0,0,0,0,5,0,0,0,0,0,2,2,1,0],
        [0,0,0,0,0,0,0,0,0,2,0,0,0,0,0,0,0,0,0],
        [0,0,0,0,0,0,0,0,0,0,0,0,0,0,0,0,0,0,0],
        [0,0,0,0,0,0,0,0,0,0,0,0,0,0,0,0,0,0,0],
        [0,0,0,0,0,0,0,0,0,0,0,0,0,0,0,0,0,0,0],
        [0,0,0,0,2,0,0,0,0,0,0,0,0,0,0,0,0,0,0],
        [2,2,2,2,1,2,2,2,2,2,2,2,2,2,2,2,2,2,2]
    ],
    "size": {
        "x": 14,
        "y": 14
    },
    "start": {
        "x": 2,
        "y": 12
    }
}